.###....#.....##..#....#.#...#...##...#.####..##.#
...........####.....#...#....#.#.#....##.#..##....
#...##..###....########....##..#..#.#.##.#..#.####
.##..#...........#.#..####.##.##..#...#.#.##...#.#
#.###.#.#..###.#.#......#.#...#.##..#.##.#..#.#...
...###..#..##..#.##......##.#.###..#.###.###..#...
#..##..#.....##.#.##.####..##..#...#...#######.#..
....#.#...##.#..#....#.#.#....#.#..#.#.##.#.#.#.#.
#...........#..###...##....##.#..#..#..#.#..#.....
###..#..#.#.#...##...###.#...#...#..#..####....#.#
##..####....#...##.#.#.......#...#.###.#.#.#.#.#.#
#.##..##..#.#.#.##.#...........##.....##....#..##.
..#...####.#.........#..#....##..#....##.##..#.##.
.#.##.....#......#.######...#..#.#..#.#.##..##...#
.##.#..#..#.#...##.#......#####.###..##.###.##.#.#
....##.###.#...#..#..#..#..#####....#....##......#
...####.....##....#.#.#..#.....#..#####.#.#.##....
.#.....#.#..#.##.##..#.##.#......#.#.##...#.##....
#.#.#...#..#.#.####.....###.##....##..##....#.#...
#.##...#...#.#......##.#.#........##.###.#.....#.#
.#.#.##.##...#.....##..#.###.#####...#..#...#.#.##
..##..##..#...#..##..####.....#..##.###.##....##..
....##..####..##.#.#.#.#.#.......###..###.#......#
.#..##....#####.#...######.#..###..#...#.#..#.#.#.
####..#..#.#...#.....##.##.#.#.###.#....#..#....#.
.#....##.#.##..##...#.#.##..#..#.##........###....
#.#.##...##.#.#.#.#..#.#..#.#....#.###..###.##..#.
...#######.##..##.##.#.#..##.#.##.#....#.#...#..#.
##..#.#....#.#..#..#.#...#.#...#...#..#..#.....#.#
..#.......##..#.....#..####...##..###..##.#.#..###
....#.....###.#..#.....#...##.....#....#........#.
...#.#...#.....##...........###...##.##.####......
..#.#....#.##....#.#...#.#..#........##.......#.#.
.#.........#.##....#..#.......#.#.#.###.###.#..###
.#.......#....##.......##.#....##.#.......##......
...#.#.##...#.#.#..#...#........#...#...#.#.##.#..
..#......#..#..#.#.##...#.##...########.##...#..#.
..#.##.###.#...#...##.###.#.#......#####.##...#..#
#....#..#..####...##.###..#....#.........#.....###
...#.#..#...####.###...#.########.#...#....####..#
##.#.#.####.....##........##....##.#.#...#..#.....
##..#.#.#...#...##..#..###...##....#...#..###.#.#.
#.#..##.#.#..###..##....###.#.#.##...###.##.....#.
.......#.......#.....#..#.....#.#...###...#.###.##
##..#..###.#.#.............#......#.#.###.##.##..#
..#..#...##........#..#......##.#...####..........
.........#.##....#...#####.###..###...#.#..#.#...#
###.##..................##.##.#.##......#..#......
...#.#.......##.....#..##...#.##..##.#.....#.###..
#.#..#.#...#.#.##.....###.#...##.#.............#.#
