~...~~..~~.~..##..~.~~....~.~#~~~....~..#.........
....#~.~......#......~..~.~~..~~~...#~..~#....~...
.~#.#..~.~..#.~~......~~..#.#~.~#.~.~...~......~~.
.~..~~.~#.~~~.~~...~#~....~..#...~.#~.~......~~.~.
.~..~.#....#.~~....~....~...~.~~.~~..~~.~~.~.~~~~.
.......#~.~~.~~........~...#...#.~..~..~~...~~..~.
...~.....~#~~~.~.~.~.~...~..~~...~..#...~~.~.#~...
.~.~.~~.~~..~.~~~~#...~..#.~~.....~..~..~~~....#..
~.~..~.~.~.~.~##.~.........~~#~~.~..#....~~~......
.~~.~~...~...~#......~~~......~.~.~.~..~~~...~..~.
.~..~~~...~#...~......#..~......~~......~....~....
~...~.........~..#.#.~.....~~........~~.~~...##.~~
..~.~~..#~.#.....#~.~.~.~.#~~~~...~~...~.~.~....~.
..~~~...~.~.#.~.~.~#~.~....~#~~...#....~.~~~...~~~
~~~..~~~..~...#....~#~..~#~~~~~...#.~...~..~#.....
~~#.#..~~~...~.~~....~.~....~...~...~#.~....~.#...
~.~..~~.#.~....~.~..~~~....~....~...#..~.~~~.#~...
~.~.~~.#.#.~.#~...~~....#~~.~~.....#.....~.~~.~...
~..~....~.~~..~.~~~~...~~...~..~....~...~.~~#~...~
.....~...~~..#.~~~~~~.~..~..~~....~~....~.~.#.~~~#
~.~.~~.~..~.~.#..~#~~....~~.~..~~...#.~#....~.#.~.
..#~~.~~.~~.~...~..~~......~~.......~.~....#~.~~..
......~.~.~..~.....~#~......##.~...~.#~...~~~~~..~
...~~~~~..~.~.~~.....~....~~..~...~~~~~#~.~.~..~.~
~~......#..~~~.~...#~~...~.~~~.........#~#...#....
~~...~....#~..~.~~~~......~~.~~~#..~~~~~...~...~##
.#.~...#~.~.#..~~.~.~...#.~.~~~..~..~~~......#....
........~.~...~.~~~..~#.#~~.#~.~.~.~~~....~#~...~.
~~..~~.~..#.~~~.......~~....#.~~.~~.~~....~.~.~..~
~~~...~.......~..~........~~.~~~.~.~...~...~.~~.~.
.......~~....~~~...~#..#.~~...~.~#~~~..~...~.#.~..
..#..#.~..~~.~...~.~.~..~.~~~..~~~...~.~#...~~..~~
..~#~~.~~#..~~~.........~..#~#.~.~....~...~.....~.
~.......~#.~..~...~.~...~..#.......#.#..~~.~~.~...
~~~~....~~...~..~~.~~~~~~~..~...#~...~~~~~.~~~...~
~.~.~..~..~.#.~...#~...~..~~..#..~~~#...~.~.~.~~.~
...#~..~~.#..........~~#~....~#...~...#....~~...~.
...#.~.#.~.~..~.~#.~..~...#...~...~~#~....~..~...~
#~...#~....~......~....~#..#~.......~...~.~~...~..
.....~~..~.~.~~.#...~...~.~~.#..~..~~~.~.......~..
~.#...~..~~.~.~.~~..~~.~.....~.....~~..~~.~.~~..~.
..#~...~.#~.....~..~##~....~~#......~.#~~~~..~~..~
.~~#..~....~~~#..~~~...~##~~~~~..~.#.....~.....#..
~~...~#~..~........~.......~..#.~~~..##~~....~~..~
~~~.....~#~..~.........#.~.~..~~...~.#~.~..~......
..~..~..~.~.~~#.#..~........~#.~..~.~.#~~~#.~.~..#
..~......~.....~.~...~...~~#..~.#.......~......~.~
#~~.~.~........~#......#~~.~.#~~~.~~...#~..~.~..~.
.#~...#~~.#..~~.~~#.#~~.~.~~~.~~.~..~~.~..~~...~..
.~..~#~.~..#.~~.......#~...~.#.~~~....~.~#...#.~.~
